"filename", "language", "SCSS", "JavaScript", "XML", "Vue", "CSS", "comment", "blank", "total"
"/Users/mac/Documents/projects/Syncio/FE-app-3.0/src/App.vue", "Vue", 0, 0, 0, 26, 0, 0, 6, 32
"/Users/mac/Documents/projects/Syncio/FE-app-3.0/src/Loading.vue", "Vue", 0, 0, 0, 27, 0, 0, 5, 32
"/Users/mac/Documents/projects/Syncio/FE-app-3.0/src/PageNotFound.vue", "Vue", 0, 0, 0, 3, 0, 0, 1, 4
"/Users/mac/Documents/projects/Syncio/FE-app-3.0/src/assets/images/marketplace.svg", "XML", 0, 0, 69, 0, 0, 0, 1, 70
"/Users/mac/Documents/projects/Syncio/FE-app-3.0/src/assets/images/multilocation.svg", "XML", 0, 0, 39, 0, 0, 0, 1, 40
"/Users/mac/Documents/projects/Syncio/FE-app-3.0/src/assets/images/waitlist.svg", "XML", 0, 0, 82, 0, 0, 0, 1, 83
"/Users/mac/Documents/projects/Syncio/FE-app-3.0/src/assets/images/woo-shopify.svg", "XML", 0, 0, 60, 0, 0, 0, 1, 61
"/Users/mac/Documents/projects/Syncio/FE-app-3.0/src/assets/scss/base.scss", "SCSS", 791, 0, 0, 0, 0, 9, 157, 957
"/Users/mac/Documents/projects/Syncio/FE-app-3.0/src/assets/scss/button.scss", "SCSS", 94, 0, 0, 0, 0, 0, 19, 113
"/Users/mac/Documents/projects/Syncio/FE-app-3.0/src/assets/scss/components/pagination.scss", "SCSS", 68, 0, 0, 0, 0, 0, 15, 83
"/Users/mac/Documents/projects/Syncio/FE-app-3.0/src/assets/scss/header.scss", "SCSS", 81, 0, 0, 0, 0, 1, 14, 96
"/Users/mac/Documents/projects/Syncio/FE-app-3.0/src/assets/scss/main.scss", "SCSS", 7, 0, 0, 0, 0, 0, 2, 9
"/Users/mac/Documents/projects/Syncio/FE-app-3.0/src/assets/scss/marketPlace/profiles.scss", "SCSS", 70, 0, 0, 0, 0, 0, 15, 85
"/Users/mac/Documents/projects/Syncio/FE-app-3.0/src/assets/scss/utilities.scss", "SCSS", 81, 0, 0, 0, 0, 3, 24, 108
"/Users/mac/Documents/projects/Syncio/FE-app-3.0/src/assets/scss/variables.scss", "SCSS", 22, 0, 0, 0, 0, 2, 4, 28
"/Users/mac/Documents/projects/Syncio/FE-app-3.0/src/components/header/Header.vue", "Vue", 0, 0, 0, 108, 0, 0, 15, 123
"/Users/mac/Documents/projects/Syncio/FE-app-3.0/src/components/header/components/ShopifyPermissionsDialog.vue", "Vue", 0, 0, 0, 27, 0, 0, 4, 31
"/Users/mac/Documents/projects/Syncio/FE-app-3.0/src/components/navbar/AddonUsage.vue", "Vue", 0, 0, 0, 56, 0, 0, 6, 62
"/Users/mac/Documents/projects/Syncio/FE-app-3.0/src/components/navbar/AddonsUsageIndicator.vue", "Vue", 0, 0, 0, 30, 0, 0, 4, 34
"/Users/mac/Documents/projects/Syncio/FE-app-3.0/src/components/navbar/NavLink.vue", "Vue", 0, 0, 0, 46, 0, 0, 3, 49
"/Users/mac/Documents/projects/Syncio/FE-app-3.0/src/components/navbar/Navbar.vue", "Vue", 0, 0, 0, 128, 0, 4, 14, 146
"/Users/mac/Documents/projects/Syncio/FE-app-3.0/src/components/shared/AppLink.vue", "Vue", 0, 0, 0, 22, 0, 0, 2, 24
"/Users/mac/Documents/projects/Syncio/FE-app-3.0/src/components/shared/BatteryLowDialog.vue", "Vue", 0, 0, 0, 33, 0, 0, 4, 37
"/Users/mac/Documents/projects/Syncio/FE-app-3.0/src/components/shared/BulkSelectedCount.vue", "Vue", 0, 0, 0, 24, 0, 0, 2, 26
"/Users/mac/Documents/projects/Syncio/FE-app-3.0/src/components/shared/CardWrapper.vue", "Vue", 0, 0, 0, 29, 0, 0, 2, 31
"/Users/mac/Documents/projects/Syncio/FE-app-3.0/src/components/shared/CheckboxWrapper.vue", "Vue", 0, 0, 0, 28, 0, 0, 5, 33
"/Users/mac/Documents/projects/Syncio/FE-app-3.0/src/components/shared/Date.vue", "Vue", 0, 0, 0, 26, 0, 0, 4, 30
"/Users/mac/Documents/projects/Syncio/FE-app-3.0/src/components/shared/DialogWrapper.vue", "Vue", 0, 0, 0, 51, 0, 0, 9, 60
"/Users/mac/Documents/projects/Syncio/FE-app-3.0/src/components/shared/LeavingPageDialog.vue", "Vue", 0, 0, 0, 28, 0, 0, 6, 34
"/Users/mac/Documents/projects/Syncio/FE-app-3.0/src/components/shared/NetworkDialog.vue", "Vue", 0, 0, 0, 29, 0, 0, 4, 33
"/Users/mac/Documents/projects/Syncio/FE-app-3.0/src/components/shared/PageHeader.vue", "Vue", 0, 0, 0, 37, 0, 0, 2, 39
"/Users/mac/Documents/projects/Syncio/FE-app-3.0/src/components/shared/Pagination.vue", "Vue", 0, 0, 0, 88, 0, 0, 18, 106
"/Users/mac/Documents/projects/Syncio/FE-app-3.0/src/components/shared/SearchFilter.vue", "Vue", 0, 0, 0, 43, 0, 0, 9, 52
"/Users/mac/Documents/projects/Syncio/FE-app-3.0/src/components/shared/StatusIcon.vue", "Vue", 0, 0, 0, 15, 0, 0, 2, 17
"/Users/mac/Documents/projects/Syncio/FE-app-3.0/src/components/shared/StoresFilter.vue", "Vue", 0, 0, 0, 44, 0, 0, 8, 52
"/Users/mac/Documents/projects/Syncio/FE-app-3.0/src/components/shared/Strong.vue", "Vue", 0, 0, 0, 5, 0, 0, 1, 6
"/Users/mac/Documents/projects/Syncio/FE-app-3.0/src/composables/axiosService.js", "JavaScript", 0, 134, 0, 0, 0, 0, 21, 155
"/Users/mac/Documents/projects/Syncio/FE-app-3.0/src/composables/checkbox.js", "JavaScript", 0, 22, 0, 0, 0, 0, 5, 27
"/Users/mac/Documents/projects/Syncio/FE-app-3.0/src/composables/filters.js", "JavaScript", 0, 54, 0, 0, 0, 0, 11, 65
"/Users/mac/Documents/projects/Syncio/FE-app-3.0/src/composables/presetRanges.js", "JavaScript", 0, 21, 0, 0, 0, 1, 4, 26
"/Users/mac/Documents/projects/Syncio/FE-app-3.0/src/composables/toasts.js", "JavaScript", 0, 29, 0, 0, 0, 0, 5, 34
"/Users/mac/Documents/projects/Syncio/FE-app-3.0/src/composables/upgradeDialog.js", "JavaScript", 0, 29, 0, 0, 0, 0, 6, 35
"/Users/mac/Documents/projects/Syncio/FE-app-3.0/src/composables/useEmailValidation.js", "JavaScript", 0, 11, 0, 0, 0, 0, 3, 14
"/Users/mac/Documents/projects/Syncio/FE-app-3.0/src/icons/IconDashboardEmpty.vue", "Vue", 0, 0, 0, 89, 0, 0, 1, 90
"/Users/mac/Documents/projects/Syncio/FE-app-3.0/src/icons/IconInstagram.vue", "Vue", 0, 0, 0, 7, 0, 0, 1, 8
"/Users/mac/Documents/projects/Syncio/FE-app-3.0/src/icons/IconLinkOff.vue", "Vue", 0, 0, 0, 6, 0, 0, 1, 7
"/Users/mac/Documents/projects/Syncio/FE-app-3.0/src/icons/IconMessageSent.vue", "Vue", 0, 0, 0, 30, 0, 0, 1, 31
"/Users/mac/Documents/projects/Syncio/FE-app-3.0/src/icons/IconNext.vue", "Vue", 0, 0, 0, 10, 0, 0, 1, 11
"/Users/mac/Documents/projects/Syncio/FE-app-3.0/src/icons/IconPageFirst.vue", "Vue", 0, 0, 0, 7, 0, 0, 1, 8
"/Users/mac/Documents/projects/Syncio/FE-app-3.0/src/icons/IconPageLast.vue", "Vue", 0, 0, 0, 7, 0, 0, 1, 8
"/Users/mac/Documents/projects/Syncio/FE-app-3.0/src/icons/IconPageNext.vue", "Vue", 0, 0, 0, 7, 0, 0, 1, 8
"/Users/mac/Documents/projects/Syncio/FE-app-3.0/src/icons/IconPagePrev.vue", "Vue", 0, 0, 0, 7, 0, 0, 1, 8
"/Users/mac/Documents/projects/Syncio/FE-app-3.0/src/icons/IconPrevious.vue", "Vue", 0, 0, 0, 7, 0, 0, 1, 8
"/Users/mac/Documents/projects/Syncio/FE-app-3.0/src/icons/IconProducts.vue", "Vue", 0, 0, 0, 45, 0, 0, 1, 46
"/Users/mac/Documents/projects/Syncio/FE-app-3.0/src/icons/IconSendMessage.vue", "Vue", 0, 0, 0, 22, 0, 0, 1, 23
"/Users/mac/Documents/projects/Syncio/FE-app-3.0/src/icons/IconShopify.vue", "Vue", 0, 0, 0, 26, 0, 0, 4, 30
"/Users/mac/Documents/projects/Syncio/FE-app-3.0/src/icons/IconWoo.vue", "Vue", 0, 0, 0, 12, 0, 0, 1, 13
"/Users/mac/Documents/projects/Syncio/FE-app-3.0/src/icons/Logo.vue", "Vue", 0, 0, 0, 45, 0, 0, 1, 46
"/Users/mac/Documents/projects/Syncio/FE-app-3.0/src/icons/LogoDark.vue", "Vue", 0, 0, 0, 45, 0, 0, 1, 46
"/Users/mac/Documents/projects/Syncio/FE-app-3.0/src/icons/LogoSmall.vue", "Vue", 0, 0, 0, 21, 0, 0, 1, 22
"/Users/mac/Documents/projects/Syncio/FE-app-3.0/src/layouts/loggedIn.vue", "Vue", 0, 0, 0, 18, 0, 0, 3, 21
"/Users/mac/Documents/projects/Syncio/FE-app-3.0/src/layouts/loggedOut.vue", "Vue", 0, 0, 0, 15, 0, 0, 2, 17
"/Users/mac/Documents/projects/Syncio/FE-app-3.0/src/layouts/onboarding.vue", "Vue", 0, 0, 0, 15, 0, 0, 2, 17
"/Users/mac/Documents/projects/Syncio/FE-app-3.0/src/main.js", "JavaScript", 0, 144, 0, 0, 0, 18, 20, 182
"/Users/mac/Documents/projects/Syncio/FE-app-3.0/src/router/index.js", "JavaScript", 0, 177, 0, 0, 0, 7, 8, 192
"/Users/mac/Documents/projects/Syncio/FE-app-3.0/src/routes.js", "JavaScript", 0, 25, 0, 0, 0, 2, 3, 30
"/Users/mac/Documents/projects/Syncio/FE-app-3.0/src/stores/activityCenter/actions/deleteActivity.js", "JavaScript", 0, 8, 0, 0, 0, 0, 1, 9
"/Users/mac/Documents/projects/Syncio/FE-app-3.0/src/stores/activityCenter/actions/fetchActivities.js", "JavaScript", 0, 28, 0, 0, 0, 12, 9, 49
"/Users/mac/Documents/projects/Syncio/FE-app-3.0/src/stores/activityCenter/index.js", "JavaScript", 0, 71, 0, 0, 0, 1, 6, 78
"/Users/mac/Documents/projects/Syncio/FE-app-3.0/src/stores/auth/actions/fetchUser.js", "JavaScript", 0, 7, 0, 0, 0, 0, 1, 8
"/Users/mac/Documents/projects/Syncio/FE-app-3.0/src/stores/auth/actions/forgotPassword.js", "JavaScript", 0, 20, 0, 0, 0, 0, 2, 22
"/Users/mac/Documents/projects/Syncio/FE-app-3.0/src/stores/auth/actions/login.js", "JavaScript", 0, 23, 0, 0, 0, 9, 5, 37
"/Users/mac/Documents/projects/Syncio/FE-app-3.0/src/stores/auth/actions/registerUser.js", "JavaScript", 0, 30, 0, 0, 0, 0, 5, 35
"/Users/mac/Documents/projects/Syncio/FE-app-3.0/src/stores/auth/actions/saveShopifyToken.js", "JavaScript", 0, 13, 0, 0, 0, 0, 3, 16
"/Users/mac/Documents/projects/Syncio/FE-app-3.0/src/stores/auth/actions/shopifyLogin.js", "JavaScript", 0, 40, 0, 0, 0, 0, 7, 47
"/Users/mac/Documents/projects/Syncio/FE-app-3.0/src/stores/auth/actions/updateStoreType.js", "JavaScript", 0, 15, 0, 0, 0, 0, 2, 17
"/Users/mac/Documents/projects/Syncio/FE-app-3.0/src/stores/auth/index.js", "JavaScript", 0, 87, 0, 0, 0, 13, 9, 109
"/Users/mac/Documents/projects/Syncio/FE-app-3.0/src/stores/connections/actions/connectPartnerStore.js", "JavaScript", 0, 11, 0, 0, 0, 0, 3, 14
"/Users/mac/Documents/projects/Syncio/FE-app-3.0/src/stores/connections/actions/deleteConnection.js", "JavaScript", 0, 10, 0, 0, 0, 0, 2, 12
"/Users/mac/Documents/projects/Syncio/FE-app-3.0/src/stores/connections/actions/fetchConnections.js", "JavaScript", 0, 18, 0, 0, 0, 2, 5, 25
"/Users/mac/Documents/projects/Syncio/FE-app-3.0/src/stores/connections/actions/fetchCurrentStore.js", "JavaScript", 0, 12, 0, 0, 0, 0, 2, 14
"/Users/mac/Documents/projects/Syncio/FE-app-3.0/src/stores/connections/actions/fetchDestinationLocations.js", "JavaScript", 0, 10, 0, 0, 0, 0, 3, 13
"/Users/mac/Documents/projects/Syncio/FE-app-3.0/src/stores/connections/actions/fetchMetadata.js", "JavaScript", 0, 9, 0, 0, 0, 0, 1, 10
"/Users/mac/Documents/projects/Syncio/FE-app-3.0/src/stores/connections/actions/fetchSourceLocations.js", "JavaScript", 0, 11, 0, 0, 0, 0, 3, 14
"/Users/mac/Documents/projects/Syncio/FE-app-3.0/src/stores/connections/actions/invitePartnerStore.js", "JavaScript", 0, 9, 0, 0, 0, 0, 2, 11
"/Users/mac/Documents/projects/Syncio/FE-app-3.0/src/stores/connections/actions/toggleMultilocation.js", "JavaScript", 0, 11, 0, 0, 0, 0, 1, 12
"/Users/mac/Documents/projects/Syncio/FE-app-3.0/src/stores/connections/actions/updateEmail.js", "JavaScript", 0, 10, 0, 0, 0, 0, 1, 11
"/Users/mac/Documents/projects/Syncio/FE-app-3.0/src/stores/connections/actions/updateLocation.js", "JavaScript", 0, 10, 0, 0, 0, 0, 1, 11
"/Users/mac/Documents/projects/Syncio/FE-app-3.0/src/stores/connections/index.js", "JavaScript", 0, 127, 0, 0, 0, 1, 21, 149
"/Users/mac/Documents/projects/Syncio/FE-app-3.0/src/stores/marketPlace/actions/fetchProfile.js", "JavaScript", 0, 33, 0, 0, 0, 0, 2, 35
"/Users/mac/Documents/projects/Syncio/FE-app-3.0/src/stores/marketPlace/actions/fetchProfiles.js", "JavaScript", 0, 36, 0, 0, 0, 0, 6, 42
"/Users/mac/Documents/projects/Syncio/FE-app-3.0/src/stores/marketPlace/actions/sendMessage.js", "JavaScript", 0, 13, 0, 0, 0, 0, 3, 16
"/Users/mac/Documents/projects/Syncio/FE-app-3.0/src/stores/marketPlace/actions/updateProfile.js", "JavaScript", 0, 60, 0, 0, 0, 0, 9, 69
"/Users/mac/Documents/projects/Syncio/FE-app-3.0/src/stores/marketPlace/index.js", "JavaScript", 0, 296, 0, 0, 0, 1, 7, 304
"/Users/mac/Documents/projects/Syncio/FE-app-3.0/src/stores/orders/actions/bulkPushOrders.js", "JavaScript", 0, 17, 0, 0, 0, 0, 4, 21
"/Users/mac/Documents/projects/Syncio/FE-app-3.0/src/stores/orders/actions/fetchOrder.js", "JavaScript", 0, 8, 0, 0, 0, 0, 1, 9
"/Users/mac/Documents/projects/Syncio/FE-app-3.0/src/stores/orders/actions/fetchOrders.js", "JavaScript", 0, 18, 0, 0, 0, 0, 1, 19
"/Users/mac/Documents/projects/Syncio/FE-app-3.0/src/stores/orders/actions/fetchPushSettings.js", "JavaScript", 0, 24, 0, 0, 0, 0, 5, 29
"/Users/mac/Documents/projects/Syncio/FE-app-3.0/src/stores/orders/actions/pushOrder.js", "JavaScript", 0, 19, 0, 0, 0, 0, 3, 22
"/Users/mac/Documents/projects/Syncio/FE-app-3.0/src/stores/orders/actions/toggleAutoPush.js", "JavaScript", 0, 5, 0, 0, 0, 0, 1, 6
"/Users/mac/Documents/projects/Syncio/FE-app-3.0/src/stores/orders/actions/updatePushSettings.js", "JavaScript", 0, 19, 0, 0, 0, 0, 3, 22
"/Users/mac/Documents/projects/Syncio/FE-app-3.0/src/stores/orders/index.js", "JavaScript", 0, 88, 0, 0, 0, 1, 7, 96
"/Users/mac/Documents/projects/Syncio/FE-app-3.0/src/stores/payouts/actions/confirmPayout.js", "JavaScript", 0, 13, 0, 0, 0, 0, 3, 16
"/Users/mac/Documents/projects/Syncio/FE-app-3.0/src/stores/payouts/actions/createPayout.js", "JavaScript", 0, 28, 0, 0, 0, 0, 4, 32
"/Users/mac/Documents/projects/Syncio/FE-app-3.0/src/stores/payouts/actions/deletePayout.js", "JavaScript", 0, 19, 0, 0, 0, 0, 1, 20
"/Users/mac/Documents/projects/Syncio/FE-app-3.0/src/stores/payouts/actions/fetchPaidPayouts.js", "JavaScript", 0, 28, 0, 0, 0, 0, 4, 32
"/Users/mac/Documents/projects/Syncio/FE-app-3.0/src/stores/payouts/actions/fetchPayableOrders.js", "JavaScript", 0, 20, 0, 0, 0, 0, 2, 22
"/Users/mac/Documents/projects/Syncio/FE-app-3.0/src/stores/payouts/actions/fetchPayout.js", "JavaScript", 0, 25, 0, 0, 0, 0, 6, 31
"/Users/mac/Documents/projects/Syncio/FE-app-3.0/src/stores/payouts/actions/fetchPayoutEvents.js", "JavaScript", 0, 16, 0, 0, 0, 0, 1, 17
"/Users/mac/Documents/projects/Syncio/FE-app-3.0/src/stores/payouts/actions/fetchPayoutOrders.js", "JavaScript", 0, 35, 0, 0, 0, 0, 6, 41
"/Users/mac/Documents/projects/Syncio/FE-app-3.0/src/stores/payouts/actions/fetchPayoutPreview.js", "JavaScript", 0, 15, 0, 0, 0, 0, 3, 18
"/Users/mac/Documents/projects/Syncio/FE-app-3.0/src/stores/payouts/actions/fetchSourcePayouts.js", "JavaScript", 0, 39, 0, 0, 0, 0, 6, 45
"/Users/mac/Documents/projects/Syncio/FE-app-3.0/src/stores/payouts/actions/fetchUnpaidPayouts.js", "JavaScript", 0, 28, 0, 0, 0, 0, 4, 32
"/Users/mac/Documents/projects/Syncio/FE-app-3.0/src/stores/payouts/actions/updatePayout.js", "JavaScript", 0, 11, 0, 0, 0, 0, 3, 14
"/Users/mac/Documents/projects/Syncio/FE-app-3.0/src/stores/payouts/index.js", "JavaScript", 0, 102, 0, 0, 0, 1, 7, 110
"/Users/mac/Documents/projects/Syncio/FE-app-3.0/src/stores/payoutsSettings/actions/bulkCommissionsUpdate.js", "JavaScript", 0, 69, 0, 0, 0, 0, 9, 78
"/Users/mac/Documents/projects/Syncio/FE-app-3.0/src/stores/payoutsSettings/actions/deleteCommission.js", "JavaScript", 0, 16, 0, 0, 0, 0, 1, 17
"/Users/mac/Documents/projects/Syncio/FE-app-3.0/src/stores/payoutsSettings/actions/fetchByProduct.js", "JavaScript", 0, 28, 0, 0, 0, 0, 6, 34
"/Users/mac/Documents/projects/Syncio/FE-app-3.0/src/stores/payoutsSettings/actions/updateStoreCommission.js", "JavaScript", 0, 17, 0, 0, 0, 0, 3, 20
"/Users/mac/Documents/projects/Syncio/FE-app-3.0/src/stores/payoutsSettings/index.js", "JavaScript", 0, 60, 0, 0, 0, 1, 6, 67
"/Users/mac/Documents/projects/Syncio/FE-app-3.0/src/stores/plan/actions/activateCharge.js", "JavaScript", 0, 18, 0, 0, 0, 0, 3, 21
"/Users/mac/Documents/projects/Syncio/FE-app-3.0/src/stores/plan/actions/fetchCurrentPlan.js", "JavaScript", 0, 12, 0, 0, 0, 0, 2, 14
"/Users/mac/Documents/projects/Syncio/FE-app-3.0/src/stores/plan/actions/fetchPlans.js", "JavaScript", 0, 15, 0, 0, 0, 0, 1, 16
"/Users/mac/Documents/projects/Syncio/FE-app-3.0/src/stores/plan/actions/generateCharge.js", "JavaScript", 0, 28, 0, 0, 0, 0, 5, 33
"/Users/mac/Documents/projects/Syncio/FE-app-3.0/src/stores/plan/index.js", "JavaScript", 0, 110, 0, 0, 0, 1, 22, 133
"/Users/mac/Documents/projects/Syncio/FE-app-3.0/src/stores/productSettings/actions/fetchSettings.js", "JavaScript", 0, 32, 0, 0, 0, 0, 7, 39
"/Users/mac/Documents/projects/Syncio/FE-app-3.0/src/stores/productSettings/actions/updateSettings.js", "JavaScript", 0, 29, 0, 0, 0, 0, 4, 33
"/Users/mac/Documents/projects/Syncio/FE-app-3.0/src/stores/productSettings/index.js", "JavaScript", 0, 37, 0, 0, 0, 1, 5, 43
"/Users/mac/Documents/projects/Syncio/FE-app-3.0/src/stores/products/actions/bulkSyncProducts.js", "JavaScript", 0, 14, 0, 0, 0, 0, 3, 17
"/Users/mac/Documents/projects/Syncio/FE-app-3.0/src/stores/products/actions/fetchInventory.js", "JavaScript", 0, 12, 0, 0, 0, 0, 2, 14
"/Users/mac/Documents/projects/Syncio/FE-app-3.0/src/stores/products/actions/fetchMetaFields.js", "JavaScript", 0, 29, 0, 0, 0, 0, 6, 35
"/Users/mac/Documents/projects/Syncio/FE-app-3.0/src/stores/products/actions/fetchProductDetails.js", "JavaScript", 0, 18, 0, 0, 0, 0, 3, 21
"/Users/mac/Documents/projects/Syncio/FE-app-3.0/src/stores/products/actions/fetchProducts.js", "JavaScript", 0, 55, 0, 0, 0, 0, 9, 64
"/Users/mac/Documents/projects/Syncio/FE-app-3.0/src/stores/products/actions/mapProduct.js", "JavaScript", 0, 14, 0, 0, 0, 0, 3, 17
"/Users/mac/Documents/projects/Syncio/FE-app-3.0/src/stores/products/actions/resyncProduct.js", "JavaScript", 0, 10, 0, 0, 0, 0, 2, 12
"/Users/mac/Documents/projects/Syncio/FE-app-3.0/src/stores/products/actions/searchProduct.js", "JavaScript", 0, 14, 0, 0, 0, 0, 3, 17
"/Users/mac/Documents/projects/Syncio/FE-app-3.0/src/stores/products/actions/searchStoreProducts.js", "JavaScript", 0, 13, 0, 0, 0, 0, 3, 16
"/Users/mac/Documents/projects/Syncio/FE-app-3.0/src/stores/products/actions/startBulkMapper.js", "JavaScript", 0, 15, 0, 0, 0, 0, 4, 19
"/Users/mac/Documents/projects/Syncio/FE-app-3.0/src/stores/products/actions/syncProduct.js", "JavaScript", 0, 11, 0, 0, 0, 0, 2, 13
"/Users/mac/Documents/projects/Syncio/FE-app-3.0/src/stores/products/actions/unsyncProduct.js", "JavaScript", 0, 11, 0, 0, 0, 0, 2, 13
"/Users/mac/Documents/projects/Syncio/FE-app-3.0/src/stores/products/index.js", "JavaScript", 0, 132, 0, 0, 0, 3, 8, 143
"/Users/mac/Documents/projects/Syncio/FE-app-3.0/src/theme/theme-light.css", "CSS", 0, 0, 0, 0, 1, 0, 1, 2
"/Users/mac/Documents/projects/Syncio/FE-app-3.0/src/views/accountSettings/AccountSettingsView.vue", "Vue", 0, 0, 0, 113, 0, 27, 15, 155
"/Users/mac/Documents/projects/Syncio/FE-app-3.0/src/views/activityCenter/ActivityCenterView.vue", "Vue", 0, 0, 0, 51, 0, 0, 11, 62
"/Users/mac/Documents/projects/Syncio/FE-app-3.0/src/views/activityCenter/components/EmptyTable.vue", "Vue", 0, 0, 0, 13, 0, 0, 2, 15
"/Users/mac/Documents/projects/Syncio/FE-app-3.0/src/views/activityCenter/components/GeneralUpdates/GeneralUpdates.vue", "Vue", 0, 0, 0, 66, 0, 0, 12, 78
"/Users/mac/Documents/projects/Syncio/FE-app-3.0/src/views/activityCenter/components/GeneralUpdates/GeneralUpdatesHeader.vue", "Vue", 0, 0, 0, 40, 0, 0, 6, 46
"/Users/mac/Documents/projects/Syncio/FE-app-3.0/src/views/activityCenter/components/GeneralUpdates/GeneralUpdatesSkeleton.vue", "Vue", 0, 0, 0, 39, 0, 0, 7, 46
"/Users/mac/Documents/projects/Syncio/FE-app-3.0/src/views/activityCenter/components/OrderIssues/OrderIssues.vue", "Vue", 0, 0, 0, 85, 0, 0, 14, 99
"/Users/mac/Documents/projects/Syncio/FE-app-3.0/src/views/activityCenter/components/OrderIssues/OrderIssuesHeader.vue", "Vue", 0, 0, 0, 50, 0, 0, 7, 57
"/Users/mac/Documents/projects/Syncio/FE-app-3.0/src/views/activityCenter/components/OrderIssues/OrderIssuesSkeleton.vue", "Vue", 0, 0, 0, 41, 0, 0, 7, 48
"/Users/mac/Documents/projects/Syncio/FE-app-3.0/src/views/activityCenter/components/ProductIssues/ProductIssues.vue", "Vue", 0, 0, 0, 90, 0, 0, 14, 104
"/Users/mac/Documents/projects/Syncio/FE-app-3.0/src/views/activityCenter/components/ProductIssues/ProductIssuesHeader.vue", "Vue", 0, 0, 0, 50, 0, 0, 7, 57
"/Users/mac/Documents/projects/Syncio/FE-app-3.0/src/views/activityCenter/components/ProductIssues/ProductIssuesSkeleton.vue", "Vue", 0, 0, 0, 48, 0, 0, 7, 55
"/Users/mac/Documents/projects/Syncio/FE-app-3.0/src/views/activityCenter/composables/activities.js", "JavaScript", 0, 14, 0, 0, 0, 0, 4, 18
"/Users/mac/Documents/projects/Syncio/FE-app-3.0/src/views/connections/Connections.vue", "Vue", 0, 0, 0, 90, 0, 0, 14, 104
"/Users/mac/Documents/projects/Syncio/FE-app-3.0/src/views/connections/ConnectionsView.vue", "Vue", 0, 0, 0, 89, 0, 0, 13, 102
"/Users/mac/Documents/projects/Syncio/FE-app-3.0/src/views/connections/ConnectionsViewHeader.vue", "Vue", 0, 0, 0, 48, 0, 0, 4, 52
"/Users/mac/Documents/projects/Syncio/FE-app-3.0/src/views/connections/ConnectionsViewSkeleton.vue", "Vue", 0, 0, 0, 40, 0, 0, 7, 47
"/Users/mac/Documents/projects/Syncio/FE-app-3.0/src/views/connections/components/connect/ConnectNewStoreDialog.vue", "Vue", 0, 0, 0, 132, 0, 0, 14, 146
"/Users/mac/Documents/projects/Syncio/FE-app-3.0/src/views/connections/components/disconnect/DisconnectAndDeleteDialog.vue", "Vue", 0, 0, 0, 48, 0, 0, 7, 55
"/Users/mac/Documents/projects/Syncio/FE-app-3.0/src/views/connections/components/disconnect/DisconnectAndKeepDialog.vue", "Vue", 0, 0, 0, 44, 0, 0, 6, 50
"/Users/mac/Documents/projects/Syncio/FE-app-3.0/src/views/connections/components/disconnect/DisconnectDialog.vue", "Vue", 0, 0, 0, 59, 0, 0, 9, 68
"/Users/mac/Documents/projects/Syncio/FE-app-3.0/src/views/connections/components/multiLocation/DestinationLocationDropdown.vue", "Vue", 0, 0, 0, 66, 0, 0, 12, 78
"/Users/mac/Documents/projects/Syncio/FE-app-3.0/src/views/connections/components/multiLocation/DisableMultilocationDialog.vue", "Vue", 0, 0, 0, 42, 0, 0, 5, 47
"/Users/mac/Documents/projects/Syncio/FE-app-3.0/src/views/connections/components/multiLocation/LocationChangeConfirmationDialog.vue", "Vue", 0, 0, 0, 48, 0, 0, 5, 53
"/Users/mac/Documents/projects/Syncio/FE-app-3.0/src/views/connections/components/multiLocation/LocationChangedDialog.vue", "Vue", 0, 0, 0, 37, 0, 0, 4, 41
"/Users/mac/Documents/projects/Syncio/FE-app-3.0/src/views/connections/components/multiLocation/LocationPendingDialog.vue", "Vue", 0, 0, 0, 46, 0, 0, 7, 53
"/Users/mac/Documents/projects/Syncio/FE-app-3.0/src/views/connections/components/multiLocation/SourceInventoryDropdown.vue", "Vue", 0, 0, 0, 62, 0, 0, 12, 74
"/Users/mac/Documents/projects/Syncio/FE-app-3.0/src/views/connections/composables/connections.js", "JavaScript", 0, 56, 0, 0, 0, 0, 9, 65
"/Users/mac/Documents/projects/Syncio/FE-app-3.0/src/views/dashboard/DashboardView.vue", "Vue", 0, 0, 0, 27, 0, 0, 6, 33
"/Users/mac/Documents/projects/Syncio/FE-app-3.0/src/views/dashboard/components/DashboardLeft.vue", "Vue", 0, 0, 0, 62, 0, 0, 11, 73
"/Users/mac/Documents/projects/Syncio/FE-app-3.0/src/views/dashboard/components/DashboardRight.vue", "Vue", 0, 0, 0, 116, 0, 0, 8, 124
"/Users/mac/Documents/projects/Syncio/FE-app-3.0/src/views/login/LoginView.vue", "Vue", 0, 0, 0, 109, 0, 0, 13, 122
"/Users/mac/Documents/projects/Syncio/FE-app-3.0/src/views/marketplace/MarketplaceView.vue", "Vue", 0, 0, 0, 54, 0, 0, 8, 62
"/Users/mac/Documents/projects/Syncio/FE-app-3.0/src/views/marketplace/components/Filters.vue", "Vue", 0, 0, 0, 74, 0, 0, 9, 83
"/Users/mac/Documents/projects/Syncio/FE-app-3.0/src/views/marketplace/components/MessageDialog.vue", "Vue", 0, 0, 0, 43, 0, 0, 4, 47
"/Users/mac/Documents/projects/Syncio/FE-app-3.0/src/views/marketplace/components/MessageSentDialog.vue", "Vue", 0, 0, 0, 30, 0, 0, 4, 34
"/Users/mac/Documents/projects/Syncio/FE-app-3.0/src/views/marketplace/components/Profile.vue", "Vue", 0, 0, 0, 93, 0, 0, 7, 100
"/Users/mac/Documents/projects/Syncio/FE-app-3.0/src/views/marketplace/components/ProfileSkeleton.vue", "Vue", 0, 0, 0, 10, 0, 0, 1, 11
"/Users/mac/Documents/projects/Syncio/FE-app-3.0/src/views/marketplace/components/Profiles.vue", "Vue", 0, 0, 0, 23, 0, 0, 2, 25
"/Users/mac/Documents/projects/Syncio/FE-app-3.0/src/views/marketplace/components/Search.vue", "Vue", 0, 0, 0, 37, 0, 0, 5, 42
"/Users/mac/Documents/projects/Syncio/FE-app-3.0/src/views/marketplace/components/Survey.vue", "Vue", 0, 0, 0, 13, 0, 0, 1, 14
"/Users/mac/Documents/projects/Syncio/FE-app-3.0/src/views/marketplace/components/UserProfile.vue", "Vue", 0, 0, 0, 70, 0, 0, 3, 73
"/Users/mac/Documents/projects/Syncio/FE-app-3.0/src/views/marketplaceSettings/MarketplaceSettingsView.vue", "Vue", 0, 0, 0, 259, 0, 17, 29, 305
"/Users/mac/Documents/projects/Syncio/FE-app-3.0/src/views/marketplaceSettings/components/ProfilePreviewDialog.vue", "Vue", 0, 0, 0, 91, 0, 0, 5, 96
"/Users/mac/Documents/projects/Syncio/FE-app-3.0/src/views/notificationSettings/NotificationSettingsView.vue", "Vue", 0, 0, 0, 53, 0, 0, 7, 60
"/Users/mac/Documents/projects/Syncio/FE-app-3.0/src/views/orderPushSettings/OrderPushSettingsView.vue", "Vue", 0, 0, 0, 116, 0, 0, 15, 131
"/Users/mac/Documents/projects/Syncio/FE-app-3.0/src/views/orderPushSettings/components/EmailContact.vue", "Vue", 0, 0, 0, 71, 0, 0, 10, 81
"/Users/mac/Documents/projects/Syncio/FE-app-3.0/src/views/orderPushSettings/components/ShippingRulesRates.vue", "Vue", 0, 0, 0, 117, 0, 0, 16, 133
"/Users/mac/Documents/projects/Syncio/FE-app-3.0/src/views/orderPushSettings/components/ShippingTypeTags.vue", "Vue", 0, 0, 0, 97, 0, 0, 14, 111
"/Users/mac/Documents/projects/Syncio/FE-app-3.0/src/views/orders/OrdersView.vue", "Vue", 0, 0, 0, 197, 0, 6, 33, 236
"/Users/mac/Documents/projects/Syncio/FE-app-3.0/src/views/orders/OrdersViewHeader.vue", "Vue", 0, 0, 0, 48, 0, 0, 3, 51
"/Users/mac/Documents/projects/Syncio/FE-app-3.0/src/views/orders/OrdersViewSkeleton.vue", "Vue", 0, 0, 0, 47, 0, 0, 9, 56
"/Users/mac/Documents/projects/Syncio/FE-app-3.0/src/views/orders/components/EnableAutoPushDialog.vue", "Vue", 0, 0, 0, 76, 0, 0, 11, 87
"/Users/mac/Documents/projects/Syncio/FE-app-3.0/src/views/orders/components/OrderDetails.vue", "Vue", 0, 0, 0, 259, 0, 3, 42, 304
"/Users/mac/Documents/projects/Syncio/FE-app-3.0/src/views/orders/components/OrderDetailsSkeleton.vue", "Vue", 0, 0, 0, 132, 0, 0, 7, 139
"/Users/mac/Documents/projects/Syncio/FE-app-3.0/src/views/orders/composables/orders.js", "JavaScript", 0, 75, 0, 0, 0, 0, 11, 86
"/Users/mac/Documents/projects/Syncio/FE-app-3.0/src/views/payouts/PayoutsView.vue", "Vue", 0, 0, 0, 75, 0, 4, 16, 95
"/Users/mac/Documents/projects/Syncio/FE-app-3.0/src/views/payouts/components/createPayout/CreatePayout.vue", "Vue", 0, 0, 0, 224, 0, 0, 27, 251
"/Users/mac/Documents/projects/Syncio/FE-app-3.0/src/views/payouts/components/destinationPayouts/DestinationPayoutsHeader.vue", "Vue", 0, 0, 0, 166, 0, 0, 29, 195
"/Users/mac/Documents/projects/Syncio/FE-app-3.0/src/views/payouts/components/destinationPayouts/paid/Paid.vue", "Vue", 0, 0, 0, 86, 0, 0, 15, 101
"/Users/mac/Documents/projects/Syncio/FE-app-3.0/src/views/payouts/components/destinationPayouts/paid/PaidSkeleton.vue", "Vue", 0, 0, 0, 46, 0, 0, 8, 54
"/Users/mac/Documents/projects/Syncio/FE-app-3.0/src/views/payouts/components/destinationPayouts/payableOrders/PayableOrders.vue", "Vue", 0, 0, 0, 85, 0, 0, 16, 101
"/Users/mac/Documents/projects/Syncio/FE-app-3.0/src/views/payouts/components/destinationPayouts/payableOrders/PayableOrdersSkeleton.vue", "Vue", 0, 0, 0, 37, 0, 0, 7, 44
"/Users/mac/Documents/projects/Syncio/FE-app-3.0/src/views/payouts/components/destinationPayouts/payoutOrders/PayoutOrders.vue", "Vue", 0, 0, 0, 156, 0, 0, 29, 185
"/Users/mac/Documents/projects/Syncio/FE-app-3.0/src/views/payouts/components/destinationPayouts/payoutOrders/PayoutOrdersHeader.vue", "Vue", 0, 0, 0, 18, 0, 0, 3, 21
"/Users/mac/Documents/projects/Syncio/FE-app-3.0/src/views/payouts/components/destinationPayouts/payoutOrders/PayoutOrdersSkeleton.vue", "Vue", 0, 0, 0, 60, 0, 0, 10, 70
"/Users/mac/Documents/projects/Syncio/FE-app-3.0/src/views/payouts/components/destinationPayouts/unpaid/Unpaid.vue", "Vue", 0, 0, 0, 84, 0, 0, 15, 99
"/Users/mac/Documents/projects/Syncio/FE-app-3.0/src/views/payouts/components/payout/CommentsAndEvents.vue", "Vue", 0, 0, 0, 39, 0, 0, 8, 47
"/Users/mac/Documents/projects/Syncio/FE-app-3.0/src/views/payouts/components/payout/OrdersInvoiced.vue", "Vue", 0, 0, 0, 143, 0, 1, 27, 171
"/Users/mac/Documents/projects/Syncio/FE-app-3.0/src/views/payouts/components/payout/Payout.vue", "Vue", 0, 0, 0, 53, 0, 0, 6, 59
"/Users/mac/Documents/projects/Syncio/FE-app-3.0/src/views/payouts/components/payout/PayoutDetails.vue", "Vue", 0, 0, 0, 182, 0, 0, 23, 205
"/Users/mac/Documents/projects/Syncio/FE-app-3.0/src/views/payouts/components/sourcePayouts/SourcePayoutsHeader.vue", "Vue", 0, 0, 0, 119, 0, 0, 21, 140
"/Users/mac/Documents/projects/Syncio/FE-app-3.0/src/views/payouts/components/sourcePayouts/complete/Complete.vue", "Vue", 0, 0, 0, 79, 0, 0, 14, 93
"/Users/mac/Documents/projects/Syncio/FE-app-3.0/src/views/payouts/components/sourcePayouts/complete/CompleteSkeleton.vue", "Vue", 0, 0, 0, 45, 0, 0, 8, 53
"/Users/mac/Documents/projects/Syncio/FE-app-3.0/src/views/payouts/components/sourcePayouts/open/Open.vue", "Vue", 0, 0, 0, 91, 0, 0, 15, 106
"/Users/mac/Documents/projects/Syncio/FE-app-3.0/src/views/payouts/components/sourcePayouts/open/OpenSkeleton.vue", "Vue", 0, 0, 0, 46, 0, 0, 8, 54
"/Users/mac/Documents/projects/Syncio/FE-app-3.0/src/views/payouts/composables/payouts.js", "JavaScript", 0, 84, 0, 0, 0, 0, 18, 102
"/Users/mac/Documents/projects/Syncio/FE-app-3.0/src/views/payoutsSettings/PayoutsSettingsView.vue", "Vue", 0, 0, 0, 38, 0, 0, 6, 44
"/Users/mac/Documents/projects/Syncio/FE-app-3.0/src/views/payoutsSettings/components/BulkCommissionDialog.vue", "Vue", 0, 0, 0, 69, 0, 0, 10, 79
"/Users/mac/Documents/projects/Syncio/FE-app-3.0/src/views/payoutsSettings/components/DefaultStoreCommission.vue", "Vue", 0, 0, 0, 67, 0, 0, 11, 78
"/Users/mac/Documents/projects/Syncio/FE-app-3.0/src/views/payoutsSettings/components/product/ProductCommission.vue", "Vue", 0, 0, 0, 186, 0, 0, 28, 214
"/Users/mac/Documents/projects/Syncio/FE-app-3.0/src/views/payoutsSettings/components/product/ProductCommissionHeader.vue", "Vue", 0, 0, 0, 34, 0, 4, 6, 44
"/Users/mac/Documents/projects/Syncio/FE-app-3.0/src/views/payoutsSettings/components/product/ProductCommissionSkeleton.vue", "Vue", 0, 0, 0, 53, 0, 0, 9, 62
"/Users/mac/Documents/projects/Syncio/FE-app-3.0/src/views/payoutsSettings/components/store/StoreCommission.vue", "Vue", 0, 0, 0, 171, 0, 0, 26, 197
"/Users/mac/Documents/projects/Syncio/FE-app-3.0/src/views/payoutsSettings/components/store/StoreCommissionSkeleton.vue", "Vue", 0, 0, 0, 45, 0, 0, 8, 53
"/Users/mac/Documents/projects/Syncio/FE-app-3.0/src/views/planAndBillings/PlanAndBillingsSkeleton.vue", "Vue", 0, 0, 0, 84, 0, 0, 14, 98
"/Users/mac/Documents/projects/Syncio/FE-app-3.0/src/views/planAndBillings/PlanAndBillingsView.vue", "Vue", 0, 0, 0, 77, 0, 0, 17, 94
"/Users/mac/Documents/projects/Syncio/FE-app-3.0/src/views/planAndBillings/components/Addon.vue", "Vue", 0, 0, 0, 116, 0, 0, 20, 136
"/Users/mac/Documents/projects/Syncio/FE-app-3.0/src/views/planAndBillings/components/Addons.vue", "Vue", 0, 0, 0, 47, 0, 0, 7, 54
"/Users/mac/Documents/projects/Syncio/FE-app-3.0/src/views/planAndBillings/components/AddonsDowngradeDialog.vue", "Vue", 0, 0, 0, 49, 0, 0, 4, 53
"/Users/mac/Documents/projects/Syncio/FE-app-3.0/src/views/planAndBillings/components/Plan.vue", "Vue", 0, 0, 0, 23, 0, 0, 3, 26
"/Users/mac/Documents/projects/Syncio/FE-app-3.0/src/views/planAndBillings/components/Plans.vue", "Vue", 0, 0, 0, 48, 0, 0, 6, 54
"/Users/mac/Documents/projects/Syncio/FE-app-3.0/src/views/planAndBillings/components/Summary.vue", "Vue", 0, 0, 0, 105, 0, 0, 20, 125
"/Users/mac/Documents/projects/Syncio/FE-app-3.0/src/views/productSettings/ProductSettingsView.vue", "Vue", 0, 0, 0, 127, 0, 0, 18, 145
"/Users/mac/Documents/projects/Syncio/FE-app-3.0/src/views/productSettings/components/MetafieldsDialog.vue", "Vue", 0, 0, 0, 36, 0, 0, 5, 41
"/Users/mac/Documents/projects/Syncio/FE-app-3.0/src/views/productSettings/components/Product.vue", "Vue", 0, 0, 0, 191, 0, 1, 19, 211
"/Users/mac/Documents/projects/Syncio/FE-app-3.0/src/views/productSettings/components/ProductSkeleton.vue", "Vue", 0, 0, 0, 69, 0, 0, 3, 72
"/Users/mac/Documents/projects/Syncio/FE-app-3.0/src/views/productSettings/components/Variant.vue", "Vue", 0, 0, 0, 84, 0, 0, 13, 97
"/Users/mac/Documents/projects/Syncio/FE-app-3.0/src/views/productSettings/components/VariantSkeleton.vue", "Vue", 0, 0, 0, 57, 0, 0, 1, 58
"/Users/mac/Documents/projects/Syncio/FE-app-3.0/src/views/products/Products.vue", "Vue", 0, 0, 0, 245, 0, 0, 28, 273
"/Users/mac/Documents/projects/Syncio/FE-app-3.0/src/views/products/ProductsView.vue", "Vue", 0, 0, 0, 176, 0, 6, 33, 215
"/Users/mac/Documents/projects/Syncio/FE-app-3.0/src/views/products/ProductsViewHeader.vue", "Vue", 0, 0, 0, 191, 0, 0, 12, 203
"/Users/mac/Documents/projects/Syncio/FE-app-3.0/src/views/products/ProductsViewSkeleton.vue", "Vue", 0, 0, 0, 70, 0, 0, 13, 83
"/Users/mac/Documents/projects/Syncio/FE-app-3.0/src/views/products/components/BulkMapperDialog.vue", "Vue", 0, 0, 0, 48, 0, 0, 7, 55
"/Users/mac/Documents/projects/Syncio/FE-app-3.0/src/views/products/components/BulkSyncDialog.vue", "Vue", 0, 0, 0, 34, 0, 0, 5, 39
"/Users/mac/Documents/projects/Syncio/FE-app-3.0/src/views/products/components/DuplicateSkuDialog.vue", "Vue", 0, 0, 0, 44, 0, 0, 8, 52
"/Users/mac/Documents/projects/Syncio/FE-app-3.0/src/views/products/components/InventoryCounter.vue", "Vue", 0, 0, 0, 56, 0, 0, 13, 69
"/Users/mac/Documents/projects/Syncio/FE-app-3.0/src/views/products/components/ProductDescriptionAndVariants.vue", "Vue", 0, 0, 0, 47, 0, 0, 8, 55
"/Users/mac/Documents/projects/Syncio/FE-app-3.0/src/views/products/components/ProductDetails.vue", "Vue", 0, 0, 0, 111, 0, 0, 13, 124
"/Users/mac/Documents/projects/Syncio/FE-app-3.0/src/views/products/components/ProductDetailsDialog.vue", "Vue", 0, 0, 0, 165, 0, 3, 27, 195
"/Users/mac/Documents/projects/Syncio/FE-app-3.0/src/views/products/components/ProductStoreInfo.vue", "Vue", 0, 0, 0, 36, 0, 0, 6, 42
"/Users/mac/Documents/projects/Syncio/FE-app-3.0/src/views/products/components/unSync/UnsyncAndDeleteDialog.vue", "Vue", 0, 0, 0, 83, 0, 0, 11, 94
"/Users/mac/Documents/projects/Syncio/FE-app-3.0/src/views/products/components/unSync/UnsyncDialog.vue", "Vue", 0, 0, 0, 112, 0, 0, 16, 128
"/Users/mac/Documents/projects/Syncio/FE-app-3.0/src/views/products/composables/products.js", "JavaScript", 0, 104, 0, 0, 0, 0, 22, 126
"/Users/mac/Documents/projects/Syncio/FE-app-3.0/src/views/registration/PageDetails.vue", "Vue", 0, 0, 0, 18, 0, 0, 3, 21
"/Users/mac/Documents/projects/Syncio/FE-app-3.0/src/views/registration/PlatformSelection.vue", "Vue", 0, 0, 0, 47, 0, 0, 4, 51
"/Users/mac/Documents/projects/Syncio/FE-app-3.0/src/views/registration/Step.vue", "Vue", 0, 0, 0, 36, 0, 0, 6, 42
"/Users/mac/Documents/projects/Syncio/FE-app-3.0/src/views/registration/shopify/ConnectOrInviteStore.vue", "Vue", 0, 0, 0, 75, 0, 0, 14, 89
"/Users/mac/Documents/projects/Syncio/FE-app-3.0/src/views/registration/shopify/EmptyBase.vue", "Vue", 0, 0, 0, 22, 0, 0, 6, 28
"/Users/mac/Documents/projects/Syncio/FE-app-3.0/src/views/registration/shopify/InstallationComplete.vue", "Vue", 0, 0, 0, 81, 0, 0, 14, 95
"/Users/mac/Documents/projects/Syncio/FE-app-3.0/src/views/registration/shopify/SelectStoreType.vue", "Vue", 0, 0, 0, 88, 0, 0, 8, 96
"/Users/mac/Documents/projects/Syncio/FE-app-3.0/src/views/registration/woocommerce/CreateAccount.vue", "Vue", 0, 0, 0, 69, 0, 0, 9, 78
"/Users/mac/Documents/projects/Syncio/FE-app-3.0/src/views/registration/woocommerce/ForgotPassword.vue", "Vue", 0, 0, 0, 55, 0, 0, 8, 63
"/Users/mac/Documents/projects/Syncio/FE-app-3.0/src/views/registration/woocommerce/ResetPassword.vue", "Vue", 0, 0, 0, 1, 0, 0, 1, 2
"/Users/mac/Documents/projects/Syncio/FE-app-3.0/src/views/registration/woocommerce/SelectWooStoreType.vue", "Vue", 0, 0, 0, 66, 0, 0, 5, 71
"/Users/mac/Documents/projects/Syncio/FE-app-3.0/src/views/registration/woocommerce/VerifyStoreUrl.vue", "Vue", 0, 0, 0, 97, 0, 0, 12, 109
"/Users/mac/Documents/projects/Syncio/FE-app-3.0/src/views/settings/SettingsView.vue", "Vue", 0, 0, 0, 66, 0, 0, 10, 76
"/Users/mac/Documents/projects/Syncio/FE-app-3.0/src/views/settings/components/Setting.vue", "Vue", 0, 0, 0, 40, 0, 0, 6, 46
"Total", "-", 1214, 3403, 250, 11044, 1, 166, 2265, 18343